4	4	4	4	4	4	4	4	4	4	4	4	4	4	4
4	1	1	1	1	1	1	1	1	4	1	1	1	1	4
4	4	4	1	1	1	1	4	4	4	4	1	1	1	4
4	1	4	1	1	1	1	1	4	1	1	1	1	1	4
4	1	4	4	4	2	1	2	4	1	1	1	1	1	4
4	1	1	1	1	1	1	1	1	1	1	1	1	1	4
4	1	1	1	1	1	1	1	1	1	1	1	1	1	4
4	1	1	8	1	1	1	256	1	1	1	8	1	1	4
4	1	1	1	1	1	1	1	1	1	1	1	1	1	4
4	1	1	1	1	1	1	1	1	1	1	1	1	1	4
4	1	8	1	1	8	1	1	4	4	4	4	1	1	4
4	1	1	8	1	4	1	1	1	1	1	1	1	1	4
4	1	1	1	1	4	1	1	1	1	1	1	1	1	4
4	1	1	4	4	4	1	1	1	1	1	1	1	1	4
4	4	4	4	4	4	4	4	4	4	4	4	4	4	4
